116 116 116 116 116 116 116 116 116 116 
116 0 0 0 0 2 0 140 1 116 
116 0 0 0 2 2 2 2 2 116 
116 0 0 0 0 2 2 2 2 2 
116 0 0 0 0 0 2 2 2 2 
116 4063232 0 0 0 2 2 2 2 2 
116 4063232 4063232 0 2 2 2 2 2 2 
116 1 4063232 4063232 0 136 2 2 2 2 
116 1 1 4063232 2 2 2 2 2 2 
116 116 116 2 2 2 2 2 2 2 
