116 116 116 116 116 116 116 116 116 116 116 116 116 
116 136 0 3932160 116 0 0 0 0 0 0 140 116 
116 0 0 0 116 0 0 0 0 0 0 0 116 
116 0 0 0 116 0 0 0 0 0 0 0 116 
116 2 2 2 116 0 0 0 0 0 0 0 116 
116 2 2 2 116 1 1 1 1 1 1 1 116 
116 0 0 0 116 1 1 1 1 1 1 1 116 
116 0 0 0 116 1 1 1 1 1 1 1 116 
116 0 0 0 116 0 0 0 0 0 0 0 116 
116 0 0 0 116 0 0 0 0 0 0 0 116 
116 0 0 2 2 0 0 0 0 0 0 0 116 
116 0 0 2 2 2 0 0 0 0 0 0 116 
116 116 116 116 116 116 116 116 116 116 116 116 116 
