116 116 116 116 116 116 116 116 116 116 116 116 116 
116 0 0 0 0 0 136 0 0 0 0 0 116 
116 0 0 0 0 0 0 0 0 0 0 0 116 
116 1 1 1 1 1 1 1 1 1 1 1 116 
116 1 1 1 1 1 1 1 1 1 1 1 116 
116 0 0 0 0 0 0 0 0 0 0 0 116 
116 0 0 0 0 0 0 0 0 0 0 0 116 
116 2 2 2 2 2 2 2 2 2 2 2 116 
116 2 2 2 2 2 2 2 2 2 2 2 116 
116 0 0 0 0 0 0 0 0 0 0 0 116 
116 0 0 0 0 0 0 0 0 0 0 0 116 
116 0 0 0 0 0 140 0 0 0 0 0 116 
116 116 116 116 116 116 116 116 116 116 116 116 116 
