116 116 116 116 116 116 116 116 116 116 116 116 116 
116 4063232 1 1 1 4063232 116 0 0 0 0 140 116 
116 0 136 0 0 0 116 0 0 0 0 0 116 
116 0 0 0 0 0 116 116 1 1 1 116 116 
116 0 0 0 0 0 116 116 1 1 116 116 116 
116 0 0 0 0 0 116 0 0 0 0 0 116 
116 116 0 0 0 116 116 0 0 0 0 0 116 
116 116 2 2 2 116 116 4063232 4063232 4063232 0 0 116 
116 116 2 2 2 116 116 4063232 4063232 4063232 4063232 0 116 
116 116 2 2 2 2 0 4063232 4063232 4063232 4063232 4063232 116 
116 116 0 0 2 2 0 0 4063232 116 116 116 116 
116 116 116 0 0 0 0 0 116 116 116 116 116 
116 116 116 116 116 116 116 116 116 116 116 116 116 
