0 1 5 5 5 5 5 5 5 2 0 5 5 0 0 
1 5 5 4 5 5 0 1 5 3 0 0 5 0 0 
2 5 4 5 5 0 5 5 5 4 0 5 5 5 0 
3 5 5 6 5 5 5 5 5 5 0 5 5 5 5 
4 5 5 0 1 2 3 5 5 6 5 5 5 5 5 
5 5 5 5 5 3 5 5 6 0 5 5 5 5 5 
6 0 1 2 5 5 5 6 0 1 5 5 5 5 5 
0 1 2 3 4 5 6 5 5 5 0 5 5 5 0 
1 2 3 4 5 6 0 1 5 5 0 5 0 5 5 
2 3 4 5 6 5 5 2 5 5 0 5 0 0 5 
0 0 0 5 5 0 5 5 0 0 0 0 5 0 5 
0 0 0 5 5 5 5 5 0 0 0 0 5 0 0 
