28 28 28 28 29 10 7 7 7 7 7 7 7 7 7 
28 28 28 28 29 10 7 7 18 19 19 19 19 20 7 
28 28 28 28 29 10 7 7 24 25 25 25 25 26 7 
34 34 34 34 35 10 7 7 24 25 25 25 25 26 7 
7 7 7 7 7 7 7 7 30 31 31 31 31 32 7 
7 7 7 7 7 7 7 7 7 7 7 7 7 7 7 
7 7 7 18 19 19 20 7 7 7 7 7 7 7 7 
7 7 7 24 25 25 26 7 7 7 7 7 7 7 7 
7 7 7 30 31 31 32 7 7 7 7 7 7 7 7 
7 7 7 7 7 7 7 7 21 22 22 22 22 23 7 
7 7 7 7 7 7 7 7 27 28 28 28 28 29 7 
7 7 7 7 7 7 7 7 27 28 28 28 28 29 7 
7 7 7 7 7 7 7 7 33 34 34 34 34 35 7 
7 7 7 7 7 7 7 7 7 7 7 7 7 7 7 
7 7 7 7 7 7 7 7 7 7 7 7 7 7 7 
